{
  "tileMap": [
    [-1, -1, -1, -1, 3, 3, 3, 3, 2],
    [-1, -1, -1, -1, 3, -1, -1, -1, 2],
    [5, 4, 4, 4, 3, -1, -1, -1, 2],
    [5, -1, -1, -1, -1, -1, -1, -1, 1],
    [5, -1, -1, -1, -1, -1, -1, -1, 1],
    [5, -1, -1, -1, -1, -1, -1, -1, 1],
    [5, -1, -1, -1, -1, -1, -1, -1, 1],
    [6, -1, -1, -1, 1, -1, 1, 1, 1],
    [6, 6, 6, 6, 1, 1, 1, -1, -1]
  ],
  "spawn": { "x": 5.5, "y": 5.5, "angle": 0 },
  "floorColor": [0.44, 0.44, 0.44, 1],
  "ceilColor": [0.22, 0.22, 0.22, 1]
}